{
  "keys" : {
    "he" : {
      "a" : "ש",
      "b" : "נ",
      "c" : "ב",
      "d" : "ג",
      "e" : "ק",
      "f" : "כ",
      "g" : "ע",
      "h" : "י",
      "i" : "ן",
      "j" : "ח",
      "k" : "ל",
      "l" : "ך",
      "m" : "צ",
      "n" : "מ",
      "o" : "ם",
      "p" : "פ",
      "q" : " ",
      "r" : "ר",
      "s" : "ד",
      "t" : "א",
      "u" : "ו",
      "v" : "ה",
      "w" : "׳",
      "x" : "ס",
      "y" : "ט",
      "z" : "ז"
    },
    "gr" : {
      "modifiers" : {
        "1" : ":",
        "2" : "shift-:",
        "3" : "'",
        "4" : "shift-'",
        "5" : "[",
        "6" : "]"
      },
      "shift-:-a" : "ἀ",
      "[-a" : "ᾶ",
      "]-a" : "ᾳ",
      "shift-'-a" : "ἁ",
      ":-a" : "ά",
      "a" : "α",
      "b" : "β",
      "g" : "γ",
      "d" : "δ",
      "e" : "ε",
      "z" : "ζ",
      "h" : "η",
      "u" : "θ",
      "i" : "ι",
      "k" : "κ",
      "l" : "λ",
      "m" : "μ",
      "n" : "ν",
      "j" : "ξ",
      "o" : "ο",
      "p" : "π",
      "r" : "ρ",
      "s" : "σ",
      "w" : "ς",
      "t" : "τ",
      "y" : "υ",
      "f" : "φ",
      "x" : "χ",
      "c" : "ψ",
      "v" : "ω",
      "A" : "Α",
      "B" : "Β",
      "G" : "Γ",
      "D" : "Δ",
      "E" : "Ε",
      "Z" : "Ζ",
      "H" : "Η",
      "U" : "Θ",
      "I" : "Ι",
      "K" : "Κ",
      "L" : "Λ",
      "M" : "Μ",
      "N" : "Ν",
      "J" : "Ξ",
      "O" : "Ο",
      "P" : "Π",
      "R" : "Ρ",
      "S" : "Σ",
      "W" : "Σ",
      "T" : "Τ",
      "Y" : "Υ",
      "F" : "Φ",
      "X" : "Χ",
      "C" : "Ψ",
      "V" : "Ω"
    }
  }
}
