{
  "keys" : {
    "he" : {
      "a" : "א",
      "b" : "ב",
      "c" : "צ",
      "d" : "ד",
      "e" : "ע",
      "f" : "פ",
      "g" : "ג",
      "h" : "ה",
      "i" : "י",
      "j" : "ח",
      "k" : "כ",
      "l" : "ל",
      "m" : "מ",
      "n" : "נ",
      "o" : "ו",
      "p" : "פ",
      "q" : "ק",
      "r" : "ר",
      "s" : "ס",
      "t" : "ת",
      "u" : "ו",
      "v" : "ו",
      "w" : "ש",
      "x" : "כ",
      "y" : "ט",
      "z" : "ז",
      "A" : "ָ",
      "B" : "ּ",
      "D" : "„",
      "E" : "ֵ",
      "H" : "ח",
      "U" : "וּ",
      "I" : "ײַ",
      "K" : "ך",
      "L" : "לֹ",
      "M" : "ם",
      "N" : "ן",
      "O" : "וֹ",
      "P" : "ף",
      "R" : "Ρ",
      "S" : "ש",
      "W" : "שׁ",
      "T" : "ט",
      "Y" : "ת",
      "F" : "ף",
      "X" : "ך",
      "C" : "ץ",
      "V" : "ב"
    },
    "gr" : {
      "modifiers" : {
        "1" : ":",
        "2" : "shift-:",
        "3" : "'",
        "4" : "shift-'",
        "5" : "[",
        "6" : "]"
      },
      "shift-:-a" : "ἀ",
      "[-a" : "ᾶ",
      "]-a" : "ᾳ",
      "shift-'-a" : "ἁ",
      ":-a" : "ά",
      "a" : "α",
      "b" : "β",
      "g" : "γ",
      "d" : "δ",
      "e" : "ε",
      "z" : "ζ",
      "h" : "η",
      "u" : "θ",
      "i" : "ι",
      "k" : "κ",
      "l" : "λ",
      "m" : "μ",
      "n" : "ν",
      "j" : "ξ",
      "o" : "ο",
      "p" : "π",
      "r" : "ρ",
      "s" : "σ",
      "w" : "ς",
      "t" : "τ",
      "y" : "υ",
      "f" : "φ",
      "x" : "χ",
      "c" : "ψ",
      "v" : "ω",
      "A" : "Α",
      "B" : "Β",
      "G" : "Γ",
      "D" : "Δ",
      "E" : "Ε",
      "Z" : "Ζ",
      "H" : "Η",
      "U" : "Θ",
      "I" : "Ι",
      "K" : "Κ",
      "L" : "Λ",
      "M" : "Μ",
      "N" : "Ν",
      "J" : "Ξ",
      "O" : "Ο",
      "P" : "Π",
      "R" : "Ρ",
      "S" : "Σ",
      "W" : "Σ",
      "T" : "Τ",
      "Y" : "Υ",
      "F" : "Φ",
      "X" : "Χ",
      "C" : "Ψ",
      "V" : "Ω"
    }
  }
}
